h: sinistra 
j: in basso
k: in alto 
l: destra 
w: Primo carattere parola successiva 
b: Primo carattere parola precedente 
(nh): numero davanti al comando di movimento ti sposti di n caratteri (nh)
gg: prima riga 
G: ultima riga 
nG o ngg: jump to line
$: fine riga
0: inizio riga
: (nj per muoversi in basso) (nk per muoversi in alto) controllare la posizione della riga se superiore o minore  
:n (:100) ti sposti alla riga
x: cancella il carattere sotto il cursore 
dw: cancella una parola (d3w cancella 3 parole)
dd: cancella una riga (3dd cancella 3 righe)
y: copia il carattere sotto il cursore
yw: copia una parola (3yw copia 3 parole oppure y$ copia fino alla fine della riga) 
P: incolla prima del cursore 
p: incolla dopo il cursore 
yy: copia la riga
/parole: cerca la parola
:s/parolavecchia/nuova: sotituisce la parole
shift-v: selezione a righe
v: selezione a carattere
u: torna in dietro con le modifiche 
U: torna in dietro con la modifiche fatte in tutta la riga
shift + a: fine riga con insert mode e spazio dopo l'ultimo carattere
shift + i: inizio riga con insert mode e spazio dopo l'inizio 
i{: Selezionare l'interno delle parentesi escluse le parentesi
a{: // Comprese le parentesi
H: Muoversi a inizio scherno
M: Muoversi a mezzo scherno
L: Muoversi a fine schermo
e: Muoversi a fine parola 
E: Muoversi a fine parola ignorando la punteggiatura
b: Muoversi a inizio parola 
B: Muoversi a inizio parola ignorando la punteggiatura
f char: salta al primo carattere corrispondente avanti 
t char: salta al primo carattere corrispondente precedente
;: esegue di nuovo f,t,F,T avanti al cursore
,: esegue di nuovo f,t,F,T dietro al cursore



#Personali
Space: Salva :w
Ctrl - f: Esci 
t: Apri terminale
Ctrl - n: Apri NerdTree plugin per scorrere le cartelle


#Prova di test 
Ciao come va oggi ? 

if{
ciaocomeva
function(){
}
}